xxxxxxxxxxxxxxxxxxxxxxxxxxxxxxxxxxxxxxxxxxxxxxxxxxx
x----------------------xx-------------------------x
x----------------------xx-------------------------x
x----------------------xx-------------------------x
x----------------------xx-------------------------x
x-----xxxxxxx----------xx-------------xxxxxxx-----x
x-----xxxxxxx----------xx-------------xxxxxxx-----x
x-----xxxxxxx----------xx-------------xxxxxxx-----x
x-------------------------------------------------x
x-------------------------------------------------x
x-------------------------------------------------x
x-------------------------------------------------x
x-----xx--------xxxxxxxxxxxxxxx------------xx-----x
x-----xx--------xxxxxxxxxxxxxxx------------xx-----x
x-----xx---------------xx------------------xx-----x
x-----xx---------------xx------------------xx-----x
x-----xxxxxxxx---------xx-----------xxxxxxxxx-----x
x-----xxxxxxxx---------xx-----------xxxxxxxxx-----x
x-----xx-----------------------------------xx-----x
x-----xx-----------------------------------xx-----x
x-----xx---------xxxxx-----xxxxx-----------xx-----x
x-----xx---------x-------------x-----------xx-----x
x----------------x-------------x------------------x
x----------------x-------------x------------------x
x----------------x-------------x------------------x
x----------------xxxxxxxxxxxxxxx------------------x
x-------------------------------------------------x
x-------------------------------------------------x
x-----xx-----------------------------------xx-----x
x-----xx-----------------------------------xx-----x
x-----xx---------xxxxxxxxxxxxxxx-----------xx-----x
x-----xx---------xxxxxxxxxxxxxxx-----------xx-----x
x-----xx---------------xx------------------xx-----x
x-----xx---------------xx------------------xx-----x
x----------------------xx-------------------------x
x-------------------------------------------------x
x-------------------------------------------------x
x----------xxxxxxx-------------xxxxxxx------------x
x----------xxxxxxx-------------xxxxxxx------------x
x-------------------------------------------------x
x-------------------------------------------------x
x-------------------------------------------------x
x-------------------------------------------------x
x-------------------------------------------------x
x----------------xxxxxxxxxxxxxxx------------------x
x--------xx------xxxxxxxxxxxxxxx------xx----------x
x--------xx------------xx-------------xx----------x
x--------xx------------xx-------------xx----------x
x--------xx------------xx-------------xx----------x
x----xxxxxxxxxxx-------xx---------xxxxxxxxxxxx----x
x----xxxxxxxxxxx------------------xxxxxxxxxxxx----x
x-------------------------------------------------x
x-------------------------------------------------x
x-------------------------------------------------x
xxxxxxxxxxxxxxxxxxxxxxxxxxxxxxxxxxxxxxxxxxxxxxxxxxx